R 1400 1000
NO ./WALL1.xpm
SO ./WALL2.xpm
WE ./WALL86.xpm
EA ./WALL68.xpm
S ./barrel.xpm
F 0,173,205
C 0,30,100

        11111111111111111111111111
        1000000000110000000000001
        1011000001110000002000001
        1011000000000010020000001111
1111111110111000001110000000000001
1000000000110000011111111001111111
11110111111100011110000010N01
11110111111100111111100000001
11010100000000011100000010001
10010100220000000000000010001
1100000000000001111101111000111
1111011111110101 101111010001
111111111 111111 111111111111
